
[[[[[[[[[[[[[[[[[[[[[[[[[[[MAPA]]]]]]]]]]]]]]]]]]]]]]]]]]]]]]
////////////////////|Vi|/////////////////////////////////////
____________________|  |/////////////////////////////////////
|Restoran __________   |/////////////////////////////////////    
|      |         |  |/////////////////////////////////////     
[_________]         |  |_____________________////////////////
                    |  _____________ Apoteka |///////////////
                    |  |            |Ime     |///////////////
 ___________________|  |            [________]///////////////
 |..................|  |     ___________/////////////////////
 |.......Park.......   |_____|          |////////////////////
 |..................|  ______           |////////////////////
 [__________________]        |__________|////////////////////
 ////////////////////////////////////////////////////////////
